***********
***we******
***wwwww***
***********
*******s***
***********